name The Sorrow Crypt
win 3
#####################
#.#G......###########
#.##.#......#########
#.##..##......#G...##
#.....##.#######.####
#.##..##......##.E.##
#.#...##...##.##....#
#G###.##...##.#####.#
#.#...#G..###....G..#
#.#.#.##....#########
#.#.##...##........E#
#.#....#..###.#####.#
#.######..###.##....#
#E............##.#.G#
#####################