name The Tomb of the Skull
win 0
####################
####.....#E#...G####
###...G..#.#..G..###
##................##
#...###......###...#
#..#####....#####..#
#G..###..##..###...#
#.......####....G..#
#.......####.......#
#.....G......#...G.#
#......######......#
##....########....##
###....######....###
####G#...#G...#...##
####################